1111211111112111
1222222112112111
1212112112112111
1112122112111111
1211111111112111
1212212112112111
1211212122211111
1111212112112111
1111211111112112
1222221112222112
1212111111112112
1112222112111112
1211111112212112
1212212111112112
1111112112111112
1211212111112111
